MAPSTART
XXXXXXXXXXXXXXXXXXXXX
X                   X
X    XXXXXXXXX      X
X    X              X
X    X              X
X    XXXXXXX        X
X    X              X
X    X              X
X    XXXXXXXXX      X
X                   X
XXXXXXXXXXXXXXXXXXXXX
MAPFINISH
ITEMS
MONSTERS
ENDFILE