MAPSTART
XXXXXXXXXXXXXXXXXXXXX
X                   X
X XXXXXXXXXXXXXXXXXXX
X                   X
XXXXXXXXXXXXXXXXXXX X
X                   X
XXXXXXXXXXXXXXXXXXXXX
XXXXXXXXXXXXXXXXXXXXX
XXXXXXXXXXXXXXXXXXXXX
XXXXXXXXXXXXXXXXXXXXX
XXXXXXXXXXXXXXXXXXXXX
MAPFINISH
ITEMS
MONSTERS
ENDFILE