MAPSTART
XXXXXXXXXXXXXXXXXXXXX
X                   X
X                   X
X                   X
X X   X   XXXXXXXXXXX
X X X X             X
X  X X    XXXXXXXXXXX
X                   X
X                   X
X                   X
XXXXXXXXXXXXXXXXXXXXX
MAPFINISH
ITEMS
MONSTERS
ENDFILE